1 1
3 17
G G G G G G G G G G G G G G G G G G G G G G G G
G E E E E E E E E E E E E E S G G G G G G G G G
G G G G G G G G G G G G G G S G G G G G G G G G
G G G G G G G G G G G G G G S G G G G G G G G G
G G G G G G G G G G G G G G S G G G G G G G G G
G G G G G G G G G G G G G G S G G G G G G G G G
G G G G G G G G G G G G G G S G G G G G G G G G
G G G G G G G G G G G G G G E E E E S G G G G G
G G G G G G G G G G G G G G G G G G S G G G G G
G G G G G G G G G G G G G G G G G G S G G G G G
G G G G G G G G G G G G G G S W W W W G G G G G
G G G G G G G G G G G G G G S G G G G G G G G G
G G G G G G G G G G G G G G S G G G G G G G G G
G G G G G G G G G G G G G G S G G G G G G G G G
G G G G G G G G G G G G G G S G G G G G G G G G
G G G G G G G G G G G G G G S G G G G G G G G G
G G G G G G G G G G G G G G S G G G G G G G G G
G G G W W W W W W W W W W W W G G G G G G G G G
G G G G G G G G G G G G G G G G G G G G G G G G
G G G G G G G G G G G G G G G G G G G G G G G G
G G G G G G G G G G G G G G G G G G G G G G G G
G G G G G G G G G G G G G G G G G G G G G G G G
G G G G G G G G G G G G G G G G G G G G G G G G
G G G G G G G G G G G G G G G G G G G G G G G G
